1111111111111
100100000C001
1110011111001
1PE0110000001
1111111111111
