1111111111111
10010000C0001
1000011111001
1PE0110000001
1111111111111
