1111111111111111111111111111111111111111111111
1PC101010101010101C1010101010101010101010101E1
11010101010101010101010101010101010101010101C1
1101010101010101010101010101010101010101010101
1101010101010101010101010101010101010101010101
1101010101010101010101010101010101010101010101
1101010101010101010101010101010101010101010101
1101010101010101010101010101010101010101010101
1101010101010101010101010101010101010101010101
1101010101010101010101010101010101010101010101
1101010101010101010101010101010101010101010101
1000000000000000000000000000000000000000000001
1101010101010101010101010101010101010101010101
1101010101010101010101010101010101010101010101
1101010101010101010101010101010101010101010101
1101010101010101010101010101010101010101010101
1101010101010101010101010101010101010101010101
1101010101010101010101010101010101010101010101
1101010101010101010101010101010101010101010101
11C101010101010101C1010101010101010101010101C1
1111111111111111111111111111111111111111111111
